##########
#________#
#___V<<<_#
#___V__^_#
#_X<<__^_#
#______^_#
#___S>>^_#
#________#
#________#
##########
