#########################
#_______________________#
#_______>>>>>>>>X_______#
#___>>>>^_______________#
#___^___________________#
#___^<<<<<<<<<<<________#
#__S___________^________#
#__>>>>>>>>>>>>^________#
#_______________________#
#########################
