###################
#_S_S_S_S_S_S_S_S_#
#_v_v_v_v_v_v_v_v_#
#_>v<_>v<_>v<_>v<_#
#__v___v___v___v__#
#__>>v<<___>>v<<__#
#____v_______v____#
#____>>>>v<<<<____#
#________v________#
#________v________#
#________v________#
#________X________#
###################
