###############
#_____________#
#_____>v>>v___#
#_____^>^_>v__#
#_____^___v<__#
#_>>>>^___v___#
#_^S___v<_v___#
#_^v_Xv<^<<___#
#_^<_^<_______#
#_____________#
###############
