#########################
#_______________________#
#____S>>>>>>>>>>>>>>v___#
#___________________>>v_#
#___________>X________v_#
#___________^_____v<<<<_#
#___________^<<___v_____#
#_____________^<<<<_____#
#_______________________#
#########################
