#########################
#_______________________#
#_>>>>>v______>>>v______#
#_^____>>>>>>>^__>>>>>X_#
#_^_____________S_______#
#_^<<<<<<<<<<<<_v_______#
#_____________^<<_______#
#_______________________#
#_______________________#
#########################
